
########################
# #    #   ##B#        #
# # ## ###### ####### ##
### ##             ## ##
### ############## ## ##
###             ##    ##
###### ######## ########
###### ####            #
A      #################
