##B#######
##    ## #
##### ## #
#        #
# ###### #
A ########