####################################
#            ###########      B#####
# ###### ### ########### ###########
#     ## ###             ####    ###
##### ## #################### ######
#####           ############# ######
#     ######### ######        ######
# ######### ###        #### ########
#           ####### ####### ########
#A##################################
